//MAP CONVERTED BY dmm2tgm.py THIS HEADER COMMENT PREVENTS RECONVERSION, DO NOT REMOVE
"a" = (
/obj/effect/turf_decal/stripes/line{
	dir = 10
	},
/obj/machinery/light/floor,
/obj/structure/railing{
	dir = 10;
	layer = 4.1
	},
/turf/open/floor/plasteel/f13/vault_floor/misc/vaultrust{
	name = "metal plating"
	},
/area/shuttle/entrance_elevator)
"d" = (
/obj/effect/turf_decal/stripes/line,
/obj/structure/railing/corner{
	dir = 8
	},
/obj/docking_port/mobile/elevator{
	can_move_docking_ports = 1;
	dwidth = 1;
	height = 4;
	id = "entrance_elevator";
	name = "BOS Entrance Elevator";
	width = 5
	},
/obj/effect/turf_decal/caution,
/turf/open/floor/plasteel/f13/vault_floor/misc/vaultrust{
	name = "metal plating"
	},
/area/shuttle/entrance_elevator)
"f" = (
/obj/effect/turf_decal/stripes/line{
	dir = 1
	},
/obj/effect/turf_decal/caution{
	dir = 1
	},
/obj/structure/railing/corner{
	dir = 4
	},
/turf/open/floor/plasteel/f13/vault_floor/misc/vaultrust{
	name = "metal plating"
	},
/area/shuttle/entrance_elevator)
"h" = (
/obj/effect/turf_decal/stripes/line{
	dir = 6
	},
/obj/structure/railing{
	dir = 6;
	layer = 4.1
	},
/obj/machinery/light/floor,
/turf/open/floor/plasteel/f13/vault_floor/misc/vaultrust{
	name = "metal plating"
	},
/area/shuttle/entrance_elevator)
"t" = (
/obj/structure/railing/corner{
	dir = 4
	},
/obj/effect/turf_decal/stripes/line{
	dir = 4
	},
/turf/open/floor/plasteel/f13/vault_floor/misc/vaultrust{
	name = "metal plating"
	},
/area/shuttle/entrance_elevator)
"A" = (
/turf/open/floor/plasteel/f13/vault_floor/misc/vaultrust{
	name = "metal plating"
	},
/area/shuttle/entrance_elevator)
"D" = (
/obj/structure/railing/corner,
/obj/effect/turf_decal/stripes/line{
	dir = 4
	},
/turf/open/floor/plasteel/f13/vault_floor/misc/vaultrust{
	name = "metal plating"
	},
/area/shuttle/entrance_elevator)
"G" = (
/obj/effect/turf_decal/stripes/line{
	dir = 1
	},
/obj/effect/turf_decal/caution{
	dir = 1
	},
/obj/structure/railing/corner{
	dir = 1
	},
/turf/open/floor/plasteel/f13/vault_floor/misc/vaultrust{
	name = "metal plating"
	},
/area/shuttle/entrance_elevator)
"K" = (
/obj/effect/turf_decal/stripes/line{
	dir = 8
	},
/obj/structure/railing/corner{
	dir = 8
	},
/turf/open/floor/plasteel/f13/vault_floor/misc/vaultrust{
	name = "metal plating"
	},
/area/shuttle/entrance_elevator)
"M" = (
/obj/effect/turf_decal/caution,
/obj/structure/railing/corner,
/obj/effect/turf_decal/stripes/line,
/turf/open/floor/plasteel/f13/vault_floor/misc/vaultrust{
	name = "metal plating"
	},
/area/shuttle/entrance_elevator)
"Q" = (
/obj/effect/turf_decal/stripes/line{
	dir = 9
	},
/obj/machinery/light/floor,
/obj/structure/railing{
	color = null;
	dir = 9
	},
/turf/open/floor/plasteel/f13/vault_floor/misc/vaultrust{
	name = "metal plating"
	},
/area/shuttle/entrance_elevator)
"R" = (
/obj/effect/turf_decal/stripes/line{
	dir = 8
	},
/obj/structure/railing/corner{
	dir = 1
	},
/turf/open/floor/plasteel/f13/vault_floor/misc/vaultrust{
	name = "metal plating"
	},
/area/shuttle/entrance_elevator)
"T" = (
/obj/effect/turf_decal/stripes/line{
	dir = 5
	},
/obj/machinery/computer/shuttle/bosentryelevator{
	pixel_y = -6;
	pixel_x = -7
	},
/obj/structure/railing{
	dir = 5
	},
/obj/machinery/light/floor,
/turf/open/floor/plasteel/f13/vault_floor/misc/vaultrust{
	name = "metal plating"
	},
/area/shuttle/entrance_elevator)
"W" = (
/obj/effect/turf_decal/stripes/line{
	dir = 1
	},
/turf/open/floor/plasteel/f13/vault_floor/misc/vaultrust{
	name = "metal plating"
	},
/area/shuttle/entrance_elevator)
"Y" = (
/obj/effect/turf_decal/stripes/line,
/obj/structure/railing/corner,
/turf/open/floor/plasteel/f13/vault_floor/misc/vaultrust{
	name = "metal plating"
	},
/area/shuttle/entrance_elevator)

(1,1,1) = {"
Q
R
K
a
"}
(2,1,1) = {"
G
A
A
d
"}
(3,1,1) = {"
W
A
A
Y
"}
(4,1,1) = {"
f
A
A
M
"}
(5,1,1) = {"
T
t
D
h
"}
